{
  "field": [
    "#########################",
    "#.......................#",
    "#...##........###.......#",
    "#.....#.......#####.....#",
    "#..............###....#.#",
    "#...###....####.........#",
    "#....###........##......#",
    "#....###.....###........#",
    "#.....#####.............#",
    "#................###....#",
    "#....###.....#....###...#",
    "#....###..........###...#",
    "#...........S...........#",
    "#........#..............#",
    "#..###.........######...#",
    "#....###...........##...#",
    "#...........#...........#",
    "#.................###...#",
    "#..#.....###...######...#",
    "#.......####....###.....#",
    "#......###..............#",
    "#.................##....#",
    "#..#####................#",
    "#.............###.......#",
    "#########################"
  ],
  "initial_snake_length": 3,
  "max_step_limit": 1500,
  "rewards": {
    "timestep": -1,
    "ate_fruit": 50,
    "died": -100
  }
}
